pvn: tfk ixw bwa
xor: xia you
fsv: rkv viu rwl
tyg: axn dkq zig pfn
izh: som eil sce hwp xwo ypi jmt vqt fuv for fmd ffl yzo ssg
myb: vvt kyr kvh
xep: sik npm yxj
dxj: hnz
ihi: uwb
nul: bxo nuq
gzq: gcu xal zkl zmw
iwz: vvl akn
rnv: xia kcj ccx
vew: qov keq
ptf: tnb nwg
usl: oqt ozo
vys: tcc
zka: fjo
yon: rkv rwl
vrx: dxp kjn
sii: agk
tmp: mcd ggc cng smm
opi: sbi hia zeo tkj keu
uti: ynx fqz ebn nrg
gyl: htd dxe tks ipf
zlm: wno dwr
zgw: nsr fjo hef
mlf: fms wwk gqs
oqt: xjc
aqs: jzk fsk mqf
abm: zap udr izh wup
smj: rfh
mkm: oiw sir
jzk: ccx xia rfh
xqo: kyg nkw
zyq: xal bbn
uxu: kvh vvt gyl kyr
mvy: ydc jtd
isr: out
tjp: fft
oiw: nla bsx nni
tju: nnk inw
fbg: yxb npv ocs snt
lcn: pei dpg
sxo: iwz lwl
cim: xcb pta tst
xia: euf vae mnf cok srd gig vjn efj tvr cvp lca ylk vtx vsj yjp pvn
you: vae aeb dvl euf cok bod srd gig vjn efj tvr lca vsj tzg vtx
tnf: bel iqx
kdt: cmd tji
pfn: dxp nhv kjn
qop: keq qov
ggc: row ovq
iyp: tgt dho vuw qbt
ndf: ihi hqi
ylk: vbc zxz
ggy: zjo hbk kmv
yjp: gpw mwc
tin: xgn ihi hqi
gvz: ovq
qvi: xia
qbt: okl
nni: tqa
zbr: iyw emy wck uvf
dac: iab fty xor
pta: wsj tmp mpj
dsj: qov
yxb: vek
qfz: joe dyy
zqo: unc dbc iaw
yxc: tyg mkf xir can
nla: ent
pxv: xia ccx you rfh
jsj: kcj
hnz: ngr
jmc: uti rkc bux dve
lbb: pku pyw jtd
djz: tju vci qke
pgs: fwq
ent: qgl iaf bvr
evw: kcj rfh
tnb: rbu yjq hqf
kut: lyu
jlt: fti poy
xir: dkq pfn axn
uvf: cma vys ssk
msr: rkv
nsf: sik npm yxj
bry: aql
rup: qov
swp: qdk
fms: out
nwh: ywb
dgw: pzb imq qdk
dst: led gqs
fip: bux rkc dve
uxa: ldf pvm iaw
dxr: uxu
lcd: vpe
dwr: jab mkf xir
cef: ssl rnv cku
rkv: ofk uev
dkw: zeo tkj sbi
rqa: lfh
jfp: xfx irr
cnw: jtd pku ydc
hqi: nwg tnb lar
lfh: mcd cng smm icq
rbu: out
bfr: tzm
cqb: ztm
keu: udr
hzd: you ccx kcj xia rfh
zjo: xhe
svr: myd wyt und qrr
xog: xav kut dsj skj
ugy: qov keq lyu
akn: iav gzd
uyl: yrb
gch: qov
zkb: ike sts grc
lsc: ftw tmm
pku: msr
twn: qki koa
nwg: hqf oca
ggv: xjc uyl
ccx: srd gig vjn efj vae aeb mnf bod cok tzg vsj sii slp yjp pvn lca ylk
unc: bry qxr rai
sze: oij gzq
npm: keq qov
jmt: ogw jmc
oxg: izh wup zap udr
gzp: you
lyu: sag zrz wfl eek yrt nmm sxo qtk ipg djz ajg
cku: you ccx xia rfh
ebn: rph lcn npw xnd xom dab evk
uwb: yjq rbu oca hqf
vek: udr wup izh
euf: bfn
sto: dac ycs
xhe: zzv opi
xgy: ztm vzx cnf ohv
qxr: aql frs dax
lca: dxj unf
iyn: seg igr
dve: ebn ynx fqz
nqm: qkc tnf
dxe: aof vtm
qxi: oyr kvh gyl vvt
eii: bvr
unj: hdd
ddm: lzc xah kku ypk
xcb: lfh
qix: kyw bux uti
cjy: zrp poy peq fti
tfk: kbf sir ndh
pvr: rfh kcj you ccx
jxq: iqf blz ihr
yyi: rup mkh izs
gcu: jlt aid cjy cis
ryx: zmf zvz fft hvj xaf
vfb: gzd hnd
vqb: nyd snt yxb npv
fcp: ybi yuv agy
vsl: rsg yyi
nnk: xqt muv czm
yen: egi
hbk: exo xhe elh
hwp: zkb wjs
xdx: fms gqs led
bxo: yxj qdt npm nij
jov: cnf
ilj: zvz zmf hvj xaf
kcj: dvl cvp vae aeb ylk tzg srd vjn slp sii pvn efj
htd: vtm jfi aof
inw: jsj czm muv
hxu: egi vkc
wuu: tzm jrd ldy
cpq: tef vjs uyh
vvl: hnd gzd aqs
pmc: yyi
wsj: cng ggc smm mcd
xav: keq lyu qov
hdd: emq siw jjm fcp
qvq: hia
qgp: pzb imq
peq: nrg ynx fqz
cea: jjm siw ytu fcp
zap: zau pil edx som eil mrw msj ypi sce hwp xwo fuv vqt jmt for yzo ssg fmd ffl wuu bfr
cmd: ptf ihi xgn
wzu: xav dsj skj
for: ldy
gfc: tst rqa xcb
bke: bel dsq
snt: bql oxg
eek: tjx
grc: zgw lcd rkh kgq zka
dyy: fhv ypk lzc
cky: yky
qkc: fiv cak bel
sts: kgq rkh zgw zka
hri: qov
law: nfc pei afa
sir: bsx
vop: mcz ekm ltl ubi
coq: zap
sbi: wup zap
mkh: keq
tzm: sch osa ruf
yrb: zap udr izh wup
viu: ofk ugy gch
pdd: fxa
gya: drm iyy yxg
led: out
mnf: dph gpw mwc iyp
rwl: gch ugy ofk
fhv: gvz
qgl: out
ucw: hri izs rup mkh
fsk: you kcj
dab: ltl mcz ygi
dtq: vio qet anm
oca: out
obr: npv nyd snt
xmh: iwz pdd lwl
kmv: exo xhe elh
rph: wsh nul jyz atu
puz: fms led gqs fcq
ruf: nrg fqz
ssk: tcc vew ted
dxp: out
pyx: keq
emq: ybi gya
bgn: lhr uzc unp isr
erg: unp isr lhr
drm: yky
tvr: mtd zlm xkt
smm: yky
agi: tji ndf tin
rkc: ynx fqz ebn
bta: xav
imq: nrg ebn fqz ynx
ixi: xqt pvr muv czm
ijt: fft hvj
msj: wdq qgp
mzr: keq qov
wxq: dac pfs
nrg: onk zyg vop evk knm xnd lcn nld uun law npw
npl: wlg jyv
ohw: qke
eca: xjp hdd
xfx: anm qet vio
ssj: wup
nij: qov
hqf: out
qrr: ijd eca slq cqb kqb ubj ykp zqo jov rys gfc
uev: lyu qov
igr: bgn cnl nfb
cgt: abm bka
odk: emy wck uvf iyw cfl
ygi: awl qop mzr sso pyx
qro: kyw
ftw: ivk nqm zlg
ssl: you ccx kcj
zxz: sbo iyn
lzc: cky iud
czm: rfh
wck: oxv
dax: ovq row
unp: out
vjn: pnp lsc tec
fty: ccx kcj you rfh
znk: cfl wck
tst: tmp mpj
dvl: bwa
can: zig vrx
vpe: ynx
wkn: hbk kmv zjo
ivk: bke
zmf: ssj coq iqw qoz vzw
uim: nfb erg bgn
cng: ovq
pvm: qxr
irr: qet
tzg: dxj vbc zxz
xwo: nba zkb
xyg: hdd xjp cea aja
dbc: qxr
bel: out
mtd: yxc dwr
axn: nhv kjn
vbc: hnz
lhr: out
qoz: udr
efj: mkm tfk
cnf: ddm joe
bzx: you kcj xia
iec: xog bta
bwa: oiw
zig: nhv
xnd: dpg nfc pei afa
cfn: tpk enc
dyc: cnl
fcq: out
aof: zap
vhy: qet
myd: cim cpx slq ziw kqb ubj eca ijd uxa bqh hzz xyg jov rys zqo nrv meo
zrz: wxq sto muw
sce: qha gzq oij
npz: lcd rkh zgw
elh: zzv opi dkw
vzw: zap izh
izz: zlg
rkh: fjo vpe uye
hzz: rqa
hvj: coq vzw
bod: tec pnp
tks: vtm jfi
keq: fzm nmm hza oob zrz wfl sag zdo vdk eih cfn
oxv: tcc vew
nuq: nij sik qdt
bfg: ihr blz xhj
eqb: tcc vew tsa ted
wwk: out
ekm: qop awl
knm: day pvc odk znk zbr
tjx: ylh vkc
zkl: cjy aid
xjp: siw emq fcp ytu
qov: wfl yrt ohw fzm djz ajg hop nwh cxc xmh vdk
uun: nul put
vsj: lsc
mrw: nba wjs
agy: yxg iyy
skj: qov lyu keq
gzd: jzk
atu: nsf bxo nuq xep
ydc: vvq yon
wup: sze edx mrw eil for ssg yzo ypi xwo hwp sce vqt wuu
vci: nnk ixi inw
tgt: chr rda txt
koa: rnv ssl smj
vjs: dtq xfx irr
bql: wup zap udr
hia: zap wup izh
rai: dax frs
oic: fxa akn
seg: bgn
cry: qxi qsu myb
qha: gcu zkl xal
iyy: ovq yky
ylh: gzp evw
tkj: zap
fti: ynx nrg
vio: ovq yky
uyh: xfx dtq irr
ocs: vek
iqw: udr wup izh
mcz: sso qop mzr awl
gqs: out
txt: puz dst
eoe: chr rda okl
sch: ebn
hnd: mqf fsk jzk
fuv: qgp wdq yhs dgw
srd: kdt
cvp: mtd zlm
zeo: wup izh udr
cma: tsa
lbo: znk pvc day
kjn: out
cak: out
imy: rfh ccx kcj you
kyg: oqt ozo ggv
yxj: lyu keq qov
jyz: nuq
kqb: aja cea xjp
udr: vqt ypi hwp xwo eil msj pil zau wuu bfr yzo ssg for sze
ywb: dac ycs
afa: vrz pmc mbj rut
fdg: fqz
pzb: fqz ynx ebn
qci: kyg usl qlk nkw
zzv: tkj zeo
bbn: cjy
awl: lyu keq
oij: bbn zmw zkl
vzx: dyy
kyw: nrg ynx
bfn: ndf
hef: fqz nrg
qdt: keq lyu
iqx: out
rut: yyi ucw rsg
qnd: rnv
tsa: lyu
vvq: viu rwl rkv
gpw: tgt dho eoe qbt
nyd: oxg vek bql
uhc: out
fei: ynx fqz nrg
bsx: eii ent
ziw: ytl npl gtk pgs
iab: kcj ccx
nba: sts npz ike
cxc: muw sto wxq
uye: ynx nrg ebn
onk: ygi
tji: xgn
cfl: ssk oxv vys cma
gig: ixw tfk bwa cbp
lbn: qxi myb qsu
fjo: nrg ynx fqz
ozo: cgt xjc uyl
fzm: enc
iaw: bry
zau: nba zkb wjs
ssg: qgp swp wdq dgw
tef: vhy
cpx: tef
fft: vzw qoz iqw coq
czv: row ovq yky
poy: ynx
blz: you ccx kcj xia rfh
xal: aid jlt cjy cis
wsh: nsf bxo xep
xaf: coq ssj iqw vzw
ycs: iab imy
ybi: yxg
aql: row yky
ike: zka zgw kgq lcd
ykp: hdd xjp cea
iaf: out
bvr: out
nfb: isr uzc
zsz: led fcq fms
jyv: row
tqa: uhc lks
zmw: cis aid jlt
ajg: rpf
wfl: gbt iwz oic pdd
hop: enc
aeb: bfn agi kdt
jrd: fei osa
ofk: qov
gls: qsu
tpk: qki qnd koa ois
yuv: drm
tud: kyg
pei: vrz mbj rut vsl
pyw: yon vvq msr
ldf: rai
agk: uge hnz sbo
dph: vuw eoe tgt
ayb: mpj
rys: vjs tef
nsr: ynx fqz ebn
oyv: ydc pku
vqt: ogw jmc fip qix
yrt: enc twn tpk
wdq: qdk imq pzb
ypi: oij gzq qha
xqt: rfh you kcj ccx
ypk: gvz
xhj: xia
yzo: qha
mbj: rsg
ffl: swp qgp dgw yhs
wyt: cqb ziw jov uxa nrv jum bqh xgy unj
nbf: ekm ygi mcz ltl
slp: zlm mtd
xkt: yxc dwr wno hvo
emy: eqb cma vys ssk
dsq: out
hvo: can jab mkf
kbf: nla
xgn: lar
bak: iqf
ytu: gya agy ybi
ovq: tud qci tpo cry lbn xqo dxr xme ilj obr wkn mze vqb ryx gls ijt
mkf: zig dkq axn
gbt: vfb bpg vvl
fqz: lcn rph cnw mvy uun law dab nld nbf npw onk asc evk xba vop oyv xom xnd lbb knm rdf
nfc: mbj pmc vrz
bws: row ovq yky
sag: bak bfg
muv: rfh xia ccx kcj
gtk: jyv czv fwq wlg
okl: mlf zsz xdx
asc: put
osa: fqz
uge: uim ngr
dho: okl
jjm: yuv ybi
fiv: out
evk: odk pvc zbr znk
sgb: czv gzf
siw: ybi
sso: lyu keq qov
npw: dpg afa
ngr: cnl erg
aja: jjm
ynx: lcn asc iec lbo nld vop npw rdf lbb
ijd: pgs gtk npl ytl
dpg: rut
bqh: sgb gtk pgs ytl
nrv: ayb xcb
icq: row
xjc: yrb bka abm
vtm: izh wup udr zap
gzf: ovq row
ltl: mzr awl
kvh: ipf dxe
kku: gvz bws iud
jab: dkq pfn
zdo: sto
vkc: bzx gzp evw pxv
ufk: jfi
cnl: unp
yky: xqo tjp xme cry fbg qci ijt gls
qtk: tjx yen
row: gls lbn ggy vqb ryx mze obr fbg tpo ilj
oob: lwl iwz oic gbt
ldy: fei ruf sch
qsu: kyr vvt gyl oyr
exo: qvq zzv
zyg: wzu bta
chr: xdx zsz
ipf: aof jfi
qke: nnk
sya: ent eii lcy
put: bxo xep
fwq: ovq row
wjs: npz grc
yhs: qdk
rfh: cok ylk bod euf tvr yjp slp gig vtx srd
ztm: ddm joe
xba: mcz ekm ltl ubi
lar: rbu oca
meo: ldf unc pvm
ubi: mzr sso
iqf: you kcj
xah: iud
cbp: sir oiw
eih: bak
rpf: ixi
ndh: nni bsx sya nla
bpg: aqs
iav: jzk
npv: bql
jtd: vvq msr fsv
iud: row yky ovq
rsg: mkh rup hri
cis: zrp poy
muw: dac pfs ycs
kgq: hef
eil: zkb
vtx: kdt agi
nmm: bfg bak jxq
xom: xog wzu
vuw: txt
mpj: smm ggc
nld: jyz nul atu put
sbo: uim ngr seg dyc
vvt: dxe tks htd
izs: lyu keq
edx: zyq qha
som: qro fip ogw
pfs: fty hzd
oyr: htd ufk dxe
bux: ebn fqz
egi: bzx gzp
lks: out
anm: yky
tcc: qov
rda: puz mlf xdx dst
rdf: day odk pvc znk zbr
slq: pvm ldf
joe: ypk kku xah
mze: uxu myb qsu
nhv: out
zlg: tnf qkc bke
ytl: czv gzf jyv
frs: row
aid: fdg fti poy peq zrp
xme: xaf
pil: yhs dgw qgp wdq swp
ixw: oiw ndh
mqf: rfh xia you kcj ccx
hza: tjx hxu
yxg: ovq row
zrp: ebn ynx fqz
vae: iyp dph
mcd: row yky ovq
tec: izz ftw
mwc: qbt tgt dho
fxa: gzd aqs iav hnd
day: uvf
bka: wup izh udr
qlk: ggv
vrz: yyi
ted: keq lyu qov
sik: keq lyu
lwl: bpg vvl akn vfb
qki: qvi smj ssl cku
ois: rnv ssl
ipg: vci
zvz: coq ssj qoz vzw
wno: tyg mkf
jum: ztm vzx cnf qfz
ihr: rfh kcj you xia
jfi: udr
wlg: yky
nkw: ozo
ohv: ddm dyy
yjq: out
ubj: jfp
qdk: ebn nrg ynx fqz
ogw: dve rkc bux kyw
lcy: qgl uhc
unf: iyn uge hnz sbo
kyr: dxe ipf htd
pvc: uvf wck emy iyw cfl
pnp: tmm ftw izz
und: unj bqh cpq ijd ubj kqb ykp slq cpx cqb xgy meo nrv zqo jov rys xyg hzz gfc
vdk: twn
tmm: ivk
dkq: dxp nhv kjn
enc: ois qki cef
tpo: kmv zjo
uzc: out
iyw: ssk
qet: yky row
fmd: tzm jrd
cok: agi kdt
